11111111111111
100C0000000P01
10001000C00001
10011000000001
10000C01111001
10000000000001
1000000E0C0001
10C00000000001
11111111111111