11111111111111
100C0000000P01
10001000C00001
10011000000001
10000C01111001
10000000000001
10000000001111
10C0000000ECC1
11111111111111