11111111111111111111111111111111111111111111111111
1000000000000000000000000C000000C00000000000000001
10C01111111100000000000000000000000000000000000001
10001000000000000000000000000000000000000000000001
10001000000000000000000000000000000000000000000001
100C100000000000CC00000000000000000000000000000001
10001000000000000000000000000000000000000000000001
10000000000000000C00000000000C00000000000000000001
10P0000000000000000000000000000E000000000000000001
10000000000000000000000000000000000000000000000001
11111111111111111111111111111111111111111111111111