1111111111111111111111111
100000000C000C000000C0001
10C0111111110000000000001
1000100010000000011111001
11101000100000000000C1001
100C1000100CC000111111101
1000100000000000000111001
10000C0000000111C000C0001
10P0000000000000000110001
1000000000E00000000000001
1111111111111111111111111