11111111111111
100C0011111111
1011100C000011
1E1111111000P1
11111111111111