11111111111111
100C0011111111
10111000001111
1E1111111000P1
11111111111111