11111111111111111111111111111111111111111111111111111111
1000000000P000000000000000000C00000000000C000000000000E1
11111111111111111111111111111111111111111111111111111111